SO ./mossy.xpm

WE ./redbrick.xpm

F 211,242,136

EA ./wood.xpm

NO ./greystone.xpm

C 144,250,167


1111111
1111011
1111111
1111111
1111111
11111111111111111111111111111111111111111111
100000000000000000000000000000000000000000001
100001000000000000000000000000000000000000011
100000000000000000000000000000000000000000011
100000000000000000000000000000000000000000001
100000000000000000000000000000000000000000001
101111111100000000000000000001111111000001111
110000011101011111101111010100001000001000011
11110111 1110101 10011101000100000000000000011
11111111 1111111 11111111111111111111111111111